*********
***B    *
*     ***
* ***  C*
*     * *
*  ** * *
** *  * *
** * ** *
* A    D*
*********
