*********
***B    *
*     ***
* *   C *
*   * * *
*   * * *
** *  * *
** * ** *
* A   D *
*********
