***************
*     E*   C*D*
* ****** **** *
*   * *     * *
* *   * * * * *
* * * * * * * *
* * * * * * * *
* * * * * *   *
* * * *   * * *
* * * * * *****
* * * * *     *
* * *B  * * * *
* ******* * * *
*A        * * *
***************
