***********************
*     Z*   T* ***    E*
* ****** **** *** ** **
*   * *  C  * **  ** **
* *     * * * ****** **
* * * * * * * ***     *
* * * * * * * *** *** *
* * * * * * * * * *** *
* * * * * * *     *** *
* * * * * *   *** *** *
* * * *   * * *** *** *
* * * * * ******* *** *
* * * * *     *** *   *
* * * * * * * *** *** *
* ******* * *     *** *
*A        * * *******B*
***********************
